111111111111111111111111111111
1P00000000000000000000000000C1
100000000000C000000000000000C1
100000000000F0000000000000C0F1
1000C00000000000000000000000C1
100000000000000C000000000000F1
10000000000000000000C000000001
10000C0000000000000000000000F1
100000000000C000000000000000C1
10000000000000000000C00000C0F1
100000000000000000000000000001
1000C000000000C00000000000C001
100000000000000000000000000E01
111111111111111111111111111111
