1111111111
1P0000C001
10111110C1
100C000001
1000111101
10C0000001
1000111101
10000C0001
10000000E1
1111111111
