111111
1P0E01
111111
10C001
111111