1111111111111111111111111111111111111111
1P00000000000000000000000000000000000001
100000000C000000000000C000000000000000C1
10000000000000000000000000000000000000F1
1000000000000000000C00000000000000000001
10000000C00000000000000000000C0000000001
100000000000000000000000000000000000F001
10000C00000000000000000000000000000000F1
10000000000000000000000C00000000000000F1
1000000000000000000000000000000000000001
1000000000000000000000000000000000000001
1111111111111111111111111111111111110001
100000000000000000000000C000000000000001
10000000000C00000000000000000000000000F1
1000000000000000000000000000000000000001
10000000000000000000000000000000000000E1
1111111111111111111111111111111111111111
