111111111111
1RRRRRRRRRR1
10C00P000C01
1FFF0FFFFF01
100000C00M01
1FFF0FFFFFF1
100000000001
1FCFFFFFFFF1
10C00M000E01
1GGGGGGGGGG1
111111111111
