111111111111
1RRRRRRRRRR1
100000000C11
1FFF0FFFFF01
100000C00001
1FFF0FFFFFF1
100000000001
1FCFFFFFFFF1
10CG00000E01
1GGPGGGGGGG1
111111111111
