111111111111
1RRRRRRRRRR1
10P000000C01
1FFF00000F01
100000C00001
10000FFFF001
100000000001
10C000000001
1F0F0F0F0E01
10C000000001
1GGGGGGGGGG1
111111111111
