111111111111
1RRRRRRRRRR1
10P000000001
1FFF00000001
100000C00001
100000000001
10000FFFF001
10C000000001
1FFFFFFFFE01
100000000001
1GGGGGGGGGG1
111111111111
