1111111111111111111111111111111111111111111111111111111111111111111111111111
100000000000000000000000000000000000000C000000000000000000000000000000000001
10P0000000000C0000000000000000000000000000000000000000C000000000000000000001
1000000000000000000000C00000000000000000000000000000000000000000000000000E01
1111111111111111111111111111111111111111111111111111111111111111111111111111
